111111111111111111
1E00000CCCC00000P1
111111111111111111
