1111111111111111111111111
1E0001C000C0000C00000C001
101C01011010C000101001001
100C000010101110001001001
1P0100000C00C000000C00001
1111111111111111111111111
