111111111111111111111
1C11000C00C0000C0C001
1001C000C000011000001
11111C000C00001110C01
100000C000C00C0000001
11000100000C00001CPE1
111111111111111111111