111111111111111111111
100100000000000000001
100000000000011000001
101110000000001110001
100000000000000000001
110001000000000010PE1
111111111111111111111
