111111111111111111111
1C11000C00C0000C0C001
1100C000C100011000001
10111C001C10001110C01
100000C001C00C0000001
11000100000C00001CPE1
111111111111111111111