11000100000C00001CPE1
111111111111111111111