111111111111111111111
1C01000C00C0000C001
1000C000C000011000001
10111C000C00001110C01
100000C000C00C0000001
11000100000C00001CPE1
111111111111111111111