111111111111111111111
100100000000000000001
1000C0000C00011000001
10111C000000001110001
100000C00000000000001
11000100000C000010P01
111111111111111111111