1111111111111111111111111111111111111111111111
10H0000000001000000000000000000000000000000001
1000000000001000000000000000000000000000000001
1000111111111111111111100000000000000011000011
1000000000000000000000000000000000000000000001
1000000000000000000000000000000000000000000001
1000111111111100000000111111111111111100011001
1000000000000000000000000000000000000000000001
1111000000000000011100000000000000000000000001
1111111111111111111111111111111111111111111111