1111111111111111111111111111111111111111111111
10E0000000001000000000C00000C000000C0000000001
1000000000001000000000000000000000000000000001
1000111111111100000000111111111111111100011001
100000000000C00000C000000C00000000000000000001
1111000000000000011100000000000000000000000001
1000111111111111111111100000000000000011000011
100000C00000C000000000000C000C0000000000000001
10000000000000000000000000P0000000000000000001
1111111111111111111111111111111111111111111111