1111111111111111111111111
1000000000001000000000C01
1000000000001000000000001
1000111110011100000000111
100000000000C00000C000001
1111000000000000011100001
1000111111111111111111101
100000C00000C000000000001
1000000000000000000000001
10E0000000001000000000C01
1000000000001000000000001
1000111111111100000000111
100000000000C00000C000001
1111000000000000011100001
1000111111111111111111101
100000C00000C0000000000P1
1111111111111111111111111