1111111111111
100100C00C001
10C0011011001
10P01110010E1
1111111111111
