1111111111
1C01000C01
1000C000C1
10111C0001
100000C001
1100010PE1
1111111111